00000X0000X0
0F0000000000
000000000X00
0000X0000000
000000000000
0X0000000000
00000000000X
00000X000000
00X000000000
000000X0X000
000000000X00
0P0000000000