FFFFFFFFFF
X0XXXXXXXX
0000X00000
0000000000
0000000000
000000000X
00000X0000
X000000000
0000X00000
P0000000X0