00000X00F
00X000X00
0X0000000
0000000X0
0X00X000X
X0000X000
000000000
X0XX000PX
XXXXX00XX