FFFFFFFFFFF
XXXXXLXXXXX
00000000000
000000000X0
00K00000000
00000000000
0000000000X
00X00000X00
000000000X0
000X000X000
X00P00XX000