00X000X0
00000000
00000X0X
X0X0P0X0
00XXXX00
00000000
0X0000X0
0XF00000