00000000000000
000X000000X000
X00000000X0F00
00000000000000
000000X0000000
00000000000000
00000000000000
0000X000000000
00X0000X000000
00X000000000X0
00000000000000
00000000000K00
000L0000X00000
P00X0000000000