000X000000
0X000000X0
0X00000000
0000000000
XX0000000X
XX0000X0XF
00000X0000
0000000X00
00X000000X
000000000P