000000000
00K000000
0000P0X00
0000L0000
000LFL000
0X00L0000
00000000X
00X000000
00000X000