0000XX0000
00X0000X00
0000000000
X000XX000X
000XXXX000
0X00XX00X0
00X0000X00
000000X000
000X000000
000XFFXP00