000X0000
00X00000
000000K0
00000000
0000X00X
0X0000X0
000P00L0
00XX00XF