000X00XX
0X0000X0
00X0F000
X0000000
X0000X00
XX00XX00
00000X00
P00X000X