XX00X0XX0XX0
0000000XX000
000X000X00X0
00XP000X0F00
000X000X0000
0X0X000X0X00
000000XX0000
X000000X000X
000X0000000X
0X000X000000
0XX000000XX0
00XX00X00X00