XX0000X0X
X00000000
0000000X0
0FX000X00
00000X00X
0X00XX000
0000000X0
0000XX000
X00P00000