00X0000XX
X00000000
0000000X0
00XXXX000
X00XFX00X
000X0XX00
00000X000
XX0000000
P00000000