0000000000X000
00F00000000000
00000000000000
00000X00000000
00000000000X00
00000000000000
00000000000000
00000000000X00
0000X000000000
000000000000X0
X000000000000X
00000X00000000
00000000000000
0000X00000000P