000000000000
00X000000X00
0X00000000X0
000000000000
000000000000
000000000000
000000000000
000000000000
000000000000
0XP0000000X0
00X000000X00
000000000000